wall        1	texture
floor       0	texture
collectible C	texture
exit        E	texture
player      P	texture
enemy       X	texture health attack
enemy       T	texture health attack
11111111111
1PCE0000001
10000000001
10000010001
10011100001
10000010001
10010010001
11111111111
